@Fraulein_Antje @123Lenchen Weist du ob sie √ºberhaupt noch im Land ist?	OTHER	OTHER
@HeikoMaas Bin 1947 geboren und habe mit diesem ganzen Schei√ü nichts am Hut! Basta!	OFFENSE	PROFANITY
@laetacara @SebRoloff Soll ich Lyoner und Maggi mitbringen?	OTHER	OTHER
@sprachmittlerud @krippmarie Ja die von der Leyen....redet gerne wirr...kennen wir schon	OFFENSE	INSULT
@Anarcho161Zecke Die "Ehe f√ºr alle" ist nun per Definition f√ºr Menschen gleichen und verschiedenen Geschlechts vorgesehen. Auch mit neuem Personenstand wird man also heiraten d√ºrfen.	OTHER	OTHER
Ich bin tief best√ºrzt, ja fassungslos, dass sich jetzt auch noch Spitze d. Zentralkomitees d. Katholiken f√ºr einen Islam-Feiertag ausspricht	OTHER	OTHER
#Tuberkulose wurde vermehrt von #Fl√ºchtlingen in Deutschland eingeschleppt. |LBR| Nicht nur dass sie von unser Geld leben, nein jetzt bringen sie auch noch Seuchen mit ins Land. Dank inkompetenter Politiker offener Grenzen, Bahnhofsklatscher und Toleranz Fanatiker.	OFFENSE	ABUSE
@sissyzk B√∂hmermann ist der schlimmste Hetzer seit G√∂bbels #LaferLichterLuther	OFFENSE	INSULT
Die Bundesregierung sollt k√ºnftig nur noch von @ClausStrunz befragt werden. #Bundestag	OTHER	OTHER
Simone Peter ist optische wie Marin Le Pen nur mit h√§sslicherer Haut. #Jamaika @peter_simone	OFFENSE	INSULT
@Sunsetmission69 @ProAsyl Es zeigt vor allem, das Rechtsterrorismus ein riesiges Problem ist und trotz NSU und Anschl√§ge auf Fl√ºchtlinge immer noch verharmlost wird.	OTHER	OTHER
@LarsWinter_ @teleherzog @janboehm @ZDF Ach ja, B√∂hmermann, sich wie immer primitiv in Szene setzen wollen ü§¢ etwas mehr Niveau w√§re gut üòú	OTHER	OTHER
@Frank_Pasemann @TinaHassel Wo ist eigentlich der j√ºdische Zentralrat, habe seit Monaten nichts mehr von ihm geh√∂rt.Wenn ein Deutscher die Juden kritisiert, dann herrscht im Zentralrat Ausnahmezustand!Bei Moslems ducken sie sich feige ab.	OFFENSE	ABUSE
@Volker_Beck @fdp Nein. Die FDP arbeitet mit AfD und Linkspartei nicht zusammen. CL	OTHER	OTHER
@Beatrix_vStorch Claudia Roth ist eine Schande f√ºr Deutschland. Und eine Peinlichkeit f√ºr JEDE Partei.	OFFENSE	INSULT
@Einzelfallinfos @ibikus31 Die Zeit des kuschelns ist vorbei. Wir haben den Moslems und Islamisten Offiziell den Krieg erkl√§rt. Ein neuer Kreuzung. Sie wollten es nicht anders. 800 Jahre haben wir dem Islam Zeit gegeben um sich zu √§ndern.	OFFENSE	ABUSE
Fakt ist: SPD-regierte L√§nder blockieren Einstufung von Tunesien, Algerien und Marokko als sichere Herkunftsstaaten! #TVDuell	OTHER	OTHER
Am 16. Januar wird in Berlin verhandelt, ob der Pr√§sident des Zentralrats der Juden, Josef #Schuster, davon sprechen darf, dass Wolfgang #Gedeon (AfD-MdL BaW√º) "Holocaust-Leugnung" betreibe. |LBR| Schuster hatte eine entsprechende Unterlassungserkl√§rung verweigert.	OTHER	OTHER
@ainyrockstar @welt Oje Lindner....die gleiche Pfeife wie einst Westerwelle..!!	OFFENSE	INSULT
@Karl_Lauterbach Da erkennt man, mit was f√ºr j√§mmerlichen Deppen die abgefuckte SPD aus Machtgeilheit 4 Jahre das Volk verraten und verkauft hat !!!	OFFENSE	ABUSE
@chteffie Danke! Wir teilen die Aufregung. Morgen fr√ºh wissen wir mehr	OTHER	OTHER
@MartinaRenner @dieLinke @GBA_b_BGH Es gibt wichtigeres wie z.B Asylantenterror!	OFFENSE	ABUSE
@anna_IIna Wir haben wirklich nette Gesellschaft unter uns....	OTHER	OTHER
@journ_ali @kelghazzali Welche Rechte vom Muslimen sind denn in Europa in Gefahr?	OTHER	OTHER
@heinrichwiechm1 Sarkasmus ist die manchmal letzte M√∂glichkeit, sich vor diesem ganzen Asyl - und Migranten-Wahnsinn zu sch√ºtzen....	OFFENSE	ABUSE
Ach ja, so viel Presse heute, wir konnten noch gar nicht alles lesen und sehen. Ein aufregender Tag X :-) Wir hoffen ihr findet die Zukunft genauso spannend wie wir	OTHER	OTHER
Gauck sprach d. DEMOKRATIE d. Weimarer Republik an &gt; jedoch histor. Fakt ist, es war eine Plutokratie, gekennz. v Uneinigkeit u SPD-F√ºhrungüòú	OTHER	OTHER
Imad Karim ist wieder online. Widerstand lohnt sich!	OTHER	OTHER
Auf die SPD konnte man sich schon lange nicht mehr verlassen. Ich hoffe in vier Jahre sind die Br√ºder weg vom Fenster.	OTHER	OTHER
@hubertus_heil Ausgerechnet die scheinheiligen Heuchler aus der abgefuckten SPD reissen das Maul auf. SPD - SCHMAROTZER, P√ÑDOPHILE UND DENUNZIANTEN !!!	OFFENSE	ABUSE
welches Meth nimmt eigentlich @DoroBaer? Ihre Haut sieht ja f√ºrchterlich aus und dann das st√§ndige blinzeln #furchtbar #maischberger	OFFENSE	INSULT
@ndaktuell @dieLinke Die Caritativen Einrichtungen sind mir jetzt sowas von scheissegal! Habe Austritt aus der Kirch beantragt.!!!!!!!!	OFFENSE	PROFANITY
Wer sch√ºtzt eigentlich psychisch Kranke Menschen vor pauschalen Vorurteilen?	OTHER	OTHER
Bin gerade aus Polen zur√ºck, im Szczeciner Rathaus lacht man sich √ºber Merkels naives Kontern (Trump) krumm u. meinte: "d√ºmmer geht`s nicht"	OFFENSE	INSULT
In der Schule war Martin Schulz ein Versager. Jetzt sollen die |LBR| deutschen Steuerzahler die Schulden der Griechen √ºbernehmen. |LBR| Pfui Deibel.	OFFENSE	INSULT
@HartmutSchrewe Da er nicht in einer Kirche oder kirchlichen St√§tte aufgetreten ist, f√§llt das nicht in unsere Zust√§ndigkeit.	OTHER	OTHER
@Platiniumray Dieses Arschloch vom Wetterdienst auf Hiddensee sprach gestern Abend von "einigen Flocken" üò°	OFFENSE	INSULT
@Sepiroth1986 In den Gulagexpress und dann ab ins sibirische arbeitslager	OFFENSE	ABUSE
@GoeringEckardt Wer nichts in einer Renten- oder Krankenversicherung einbezahlt hat, darf auch keine Leistungen √ºber Sozialniveau erwarten!	OTHER	OTHER
@AfD @Joerg_Meuthen Ich vermute das Schulz der Merkel zuvorgekommen ist...das war wohl Inhalt ihrer eigenen Rede zum sp√§teren Zeitpunkt... |LBR| Das dieses beabsichtigt wird steht allerdings schon l√§nger fest....!	OTHER	OTHER
Mareike beantwortet heute gegen 14 Uhr auf @DKultur im #Kompressor, wie man sich bei uns anmeldet&amp;wie die Finanzierung der Miete klappt!	OTHER	OTHER
@SusanBrenning In Sachen Verrat war die Kirche schon immer gro√ü.	OFFENSE	ABUSE
@dushanwegner Es ist eindeutig und unmissverst√§ndlich.....unsere humanit√§re Haltung ist falsch naiv und dumm, vollkommen im Arsch.	OFFENSE	PROFANITY
@stefanolix Siehst Du denn "Hass im Netz" als eine problematische gesellschaftliche Sache an?	OTHER	OTHER
Es wird ja viel durcheinander gebracht. Daher zur Aufkl√§rung: |LBR| Eine Intersexueller kann per definition weder trans- noch homosexuell sein.	OTHER	OTHER
@MalteKaufmann @Heinrich_Krug So ist es richtig...alles im Namen der Menschlichkeit hat sich nicht bew√§hrt....!	OTHER	OTHER
Jetzt warte ich nur noch darauf bis sich der Gr√ºne Anal Ritter Volker Beck zu Wort meldet. Aber der Pudert sich gerade die Nase. :-)	OFFENSE	ABUSE
Der Weg zum Erfolg f√ºhrt in der CDU durch Merkels Ar***, Hirn braucht man nicht, Bsp. Altmaiers letzte "Wahl-√Ñu√üerung" &gt; dieser Vollpfostenüòú	OFFENSE	INSULT
@maybritillner @ZDF Wenn ich den Altmaier sehe kommt mir die Wurst.	OFFENSE	INSULT
Fakt: Es sterben jedes Jahr mehr Menschen an H2O, als an #Glyphosat. |LBR| (Bitte nicht den Gr√ºnen erz√§hlen, die wollen sonst H2O verbieten)	OTHER	OTHER
Die Gr√ºnen bleiben nur gef√ºhlte Schwesterpartei der @CDU. Wer bei Merkel Minister wird oder bleibt entscheidet immer noch @CSU. #Glyphopsat #schmidt	OTHER	OTHER
@heutejournal Ich hoffe dieses islamistische Dreckschwein wurde ohne Narkose operiert.	OFFENSE	ABUSE
Donald Trump ist ein Gro√ümaul, das die Fakten zu den verkauften Autos |LBR| in D und USA nicht kennt. Er m√∂ge sein Maul halten.	OFFENSE	INSULT
@ph1664068 Nichts auf der Welt kann einem Menschen die Mutter ersetzen. Diese Fotos sagen mehr als 1000 Worte.	OTHER	OTHER
@FrlUrban Vielmehr - Liebe passiert manchmal einfach. Sie fragt nicht: "Wer bist du und wie definierst du dich?" Sie geschieht.	OTHER	OTHER
Der Schnellhuber hat sein Diplom auch von der Gender-Uni Tuntenhausen, oder? |LBR| #gruene #bdk17	OFFENSE	ABUSE
#Bischof Dr. Matthias Ring: "Glaube ist ein t√§gliches Prebiszit ... ich muss mich jeden Tag neu bekennen" - #aksynode16 #altkatholisch	OTHER	OTHER
@IAMMASCHO @RAIMINEM Hitler wollte uns nur von der Roten Pest befreien ausserdem hatte Polen schon 1935 den Plan gehabt Deutschland anzugreifen Hitler ist ihnen nur zuvor gekommen	OFFENSE	ABUSE
@ndaktuell Typisch,Demokraten werden ausgewiesen und der Mob von Nafris darf bleiben!Armes Europa.	OFFENSE	ABUSE
Schwarz-schwarze Sondierung dauert nach 7 Stunden weiter an. Teilnehmer haben gerade alle Abendtermine abgesagt. @CDU @CSU #Jamaika	OTHER	OTHER
@mountainman1977 @MiataMuc Was hast Du gedacht, als Du zum ersten Mal erfahren hast, da√ü es Schwule gibt?	OTHER	OTHER
du kannst gar nichts @GoeringEckardt ! verbl√∂dete Studienabbrecherin. #illner	OFFENSE	INSULT
@slow_haus @JochenBittner Die meisten Verletzungen von Menschenrechten werden dort begangen, wo nichtwei√üe M√§nner leben. |LBR| Bad Luck üòé	OFFENSE	ABUSE
@MiataMuc Von mir aus darfst Du alles. |LBR| Au√üer meine Autorit√§t in Frage stellen.	OTHER	OTHER
@HPStauch @Margit030 So muss man mit dem Migrantenpack umgehen!	OFFENSE	ABUSE
@obskurOlaph Die FDP hat es doch richtig gemacht. Sondiert und die Idiotie erkannt. Und daraufhin die Sondierung abgebrochen.	OTHER	OTHER
@RegSprecher @iaamesse Merkel hat soviel Ahnung vom Auto, wie die "ber√ºhmte" Kuh vom Sonntag!	OFFENSE	INSULT
Verdammt nochmal, Ihr Afrikaner. Fangt endlich an, Eure Probleme |LBR| selbst zu l√∂sen. Nur die besser Gestellten k√∂nnen abhauen.	OFFENSE	ABUSE
Ein ehemaliger Sch√ºler von mir, Rohollah, wurde dieses Jahr nach einem komplett unfairen Verfahren (wir bei AiN haben davon leider erst erfahren, als bereits alle Instanzen ersch√∂pft waren) nach Afghanistan deportiert.	OTHER	OTHER
"Der grundgesetzliche besondere Schutz von Ehe und Familie gilt auch f√ºr Migranten." #Integration	OTHER	OTHER
Dortmund:Leipzig |LBR| Die gro√üm√§uligen Dortmunder werden von Leipzig hergespielt. Gro√üartig!	OFFENSE	INSULT
@KonseqLiberal @MiataMuc Glaub ihm nicht alles. Sexuelle Anziehungskraft ist bei M√§nnern nicht vom Beruf abh√§ngig.	OTHER	OTHER
@Alltags_Kotze Dein Feminismus und Genderquatsch steht Dir im Weg	OFFENSE	ABUSE
@spox Hoffentlich sitzt er bei den Bayern dauernd auf der Ersatzbank!	OTHER	OTHER
Selbstmordanschlag in Manchester, alle Medien geilen sich f√∂rmlich daran auf, ohne "Ursachen" zu erw√§hnen.	OFFENSE	PROFANITY
Nach einer Debatte √ºber die Zukunft der #DIG und des #JuFo besuchen wir nun eine Ausstellung im Anne-Frank-Zentrum #Israelpedia #Frankfurt	OTHER	OTHER
@MiriamOzen Selbst die L√ºge, das es keinen Anstieg der Kriminalit√§t in Altena gibt ist mit wenigen klicks im Netz wiederlegbar	OTHER	OTHER
@RegSprecher Der hat und brauchte nicht solche L√ºgen und M√§rchen den B√ºrgern zu verklickern, wie Sie Herr Seibert! Aber es gibt eben Leute, die f√ºr Geld ALLES labern!	OFFENSE	INSULT
@RenateKuenast Vielleicht sollte man erst einmal das W√∂rtchen Hass-Kommentare gesetzlich definieren bevor man hier irgendetwas unter Strafe stellt. Wo h√∂rt die Meinungsfreiheit auf und fangen Hasskommentare an?	OTHER	OTHER
Man kann s√§mtliche Sexismus-Debatten der letzte Jahre auf ein Wort reduzieren: Schwachsinn.	OFFENSE	ABUSE
@c_vogt @Grals_Hueter @JTrittin Hat der Trittin wieder vom Chem √ñzdemirs Gras geraucht?	OFFENSE	INSULT
F√ºr @DoroBaer w√§re ein bisschen abnehmen nicht verkehrt. #maischberger	OTHER	OTHER
In der aktuellen ZEIT ist ein Abdruck meines Buches "Mohamed. Eine Abrechnung" erschienen!	OTHER	OTHER
@MarcusPretzell @FraukePetry Du bist einfach nur noch l√§cherlich @MarcusPretzell . #Bundestag	OFFENSE	INSULT
T√ºrkeiurlaub gestrichen. Keinerlei Verg√ºnstigungen f√ºr T√ºrkei. Bis sich dort die |LBR| Demokraten gegen den irren Sultan wehren und ihn davonjagen	OFFENSE	INSULT
@thie_no Dann nutzen Sie einfach nicht antisemitische Stereotypen gegen√ºber uns #Juden, dann muss man ihnen auch nicht #Antisemitismus vorwerfen!	OTHER	OTHER
P√ºnktlich zum Wahlkampfauftakt ziehen sich unsere politi. Raubtiere Berlins d. Lammfell √ºber, um weitere Jahre im gleichen Trott zu agierenüòú	OFFENSE	INSULT
Davor warne ich seit Jahren: Wir m√ºssen handeln, sonst werden wir behandelt. Ja, wir werden von radikalen Islamisten, Fundamentalisten, Salafisten und Dschihadisten in unserem Land behandelt und in eine Ecke gezwungen, in der wir St√ºck f√ºr St√ºck unsere Freiheiten aufgeben.	OTHER	OTHER
@Pirat_Bernie @mlooks Nee, Schei√üe kommt woanders raus.	OFFENSE	PROFANITY
ekelhaft Claudia Roth wieder im Fernsehen sehen zu m√ºssen #Bundestag	OFFENSE	INSULT
@DerDoktorant Ich wei√ü nicht, ob die Aussage richtig ist. Das habe ich doch bereits gesagt.	OTHER	OTHER
@Mama_arbeitet @annika_schach @herr_unbekannnt K√∂nnen Sie die Frage beantworten? Warum sind 30 Prozent Frauen im Bundestag problematisch?	OTHER	OTHER
Das Krebsgeschw√ºr, das jeden Frieden im Nahen Osten verhindert, ist der dem Islam inh√§rente Herrschaftanspruch √ºber andere Kulturen, und der dem Islam inh√§rente Antisemitismus. |LBR| #IStandWithIsrael |LBR| #Jerusalem	OFFENSE	ABUSE
Das Foto des Jahres finde ich piet√§tlos u. Ausdruck daf√ºr, wie tief die von der Politik vorgelebte Hetze gegen RU in Medien verwurzelt ist ü§¢	OTHER	OTHER
Heute Abend um 19:30 in Koeln, werde in der Buchhandlung Ludwig am Hauptbahnhof aus "Mohamed" lesen!	OTHER	OTHER
@SilkeBurmester @WieVieleFrauen Tja, nur ne Vagina zu haben, reicht halt nicht.	OFFENSE	ABUSE
In England wird die Meinungsfreiheit noch gro√ü geschrieben auch ein Grund f√ºr den Brexit.	OTHER	OTHER
@_teatimecookie_ M√§nner m√∂gen Titten. Gew√∂hn Dich dran.	OFFENSE	PROFANITY
Trump |LBR| #Dekrete f√ºr Amerikaner = o.k. |LBR| #Dekrete die andere Staaten adressieren oder bedrohen sind nicht akzeptabel |LBR| zB Iran	OTHER	OTHER
Ohne #Alkohol g√§be es keinen #Alkoholismus |LBR| Ohne #Islam g√§be es keinen #Islamismus |LBR| Beides muss weg	OFFENSE	ABUSE
